00:00-0,0,0,0
00:01-0,0,1,0
00:02-0,1,0,0
00:03-0,1,1,0
00:04-0,0,1,0
00:05-1,0,0,0
00:06-1,0,0,0
00:07-0,0,1,0
00:08-0,0,1,1
00:09-0,1,0,0
00:10-0,0,1,0
00:11-0,0,0,1
00:12-0,0,1,0
00:13-0,1,0,0
00:14-1,0,0,1
00:15-0,0,1,1
00:16-0,0,1,1
00:17-1,0,0,0
00:18-0,1,0,0
00:19-0,1,1,0
00:20-0,0,0,1
00:21-0,1,1,0
00:22-0,1,0,0
00:23-1,0,0,0
00:24-0,1,1,0
00:25-1,0,0,0
00:26-1,0,0,0
00:28-0,1,0,0
00:29-0,0,1,0
00:30-0,0,1,0
00:31-0,0,0,1
00:32-0,0,1,1
00:33-1,1,0,0
00:34-0,0,1,1
00:35-0,1,0,0
00:36-1,0,0,1
00:37-0,1,0,0
00:38-0,0,1,0
00:39-0,1,1,0
00:40-1,0,0,0
00:41-0,1,0,0
00:42-0,1,0,0
00:43-0,1,0,0
00:44-0,0,1,0
00:45-1,0,0,1
00:46-1,0,0,1
00:47-1,0,0,1
00:48-0,1,1,0
01:23-1,1,1,1
