00:00-0,0,0,0
00:01-0,0,1,0
00:02-0,1,0,0
00:03-0,1,1,0
00:04-0,0,1,0
00:05-1,0,0,0
00:06-1,0,0,0
00:07-0,0,1,0
00:08-0,0,1,1
00:09-0,1,0,0
00:10-0,1,0,0
00:11-0,1,0,0
00:12-0,0,1,1
00:13-0,0,1,0
00:14-0,1,0,0
00:15-0,0,1,0
00:16-0,0,0,1
00:17-1,0,0,0
00:18-0,0,1,0
00:19-0,0,1,0
00:20-0,1,0,0
00:21-0,0,0,1
00:22-1,0,0,0
00:23-0,1,1,0
00:24-1,0,1,0
00:25-1,0,0,0
00:26-1,0,1,0
00:27-0,0,0,1
00:28-1,0,1,0
00:29-0,0,0,1
00:30-0,0,1,0
00:31-0,1,1,0
00:32-0,1,0,0
00:33-0,1,1,0
00:34-1,1,0,0
00:35-1,0,1,0
00:36-1,0,0,0
00:37-1,0,1,0
00:38-0,1,1,0
00:39-0,0,1,0
00:40-0,1,1,0
00:41-0,0,1,0
00:42-1,0,0,0
00:43-1,0,1,0
00:44-0,1,1,0
00:45-0,0,0,1
00:46-0,1,1,0
00:47-0,0,0,1
00:48-0,0,1,1
00:49-0,1,1,0
00:50-0,1,0,1
00:51-0,0,0,1
00:52-0,1,0,1
00:53-0,0,0,0
00:54-0,1,0,0
00:55-0,1,1,0
00:56-1,1,0,0
00:57-0,1,1,1
00:58-1,1,0,1
00:59-1,0,0,0
01:01-0,1,1,0
01:02-1,1,0,0
01:03-0,1,1,0
01:04-0,0,1,0
01:05-0,0,0,1
01:06-0,0,0,1
01:07-1,1,0,0
01:08-0,0,1,0
01:09-0,0,1,1
01:10-0,0,0,1
01:11-0,1,1,0
01:12-0,0,1,1
01:13-0,1,1,0
01:14-1,0,0,0
01:15-0,0,1,1
01:16-0,0,1,0
01:17-1,0,0,0
01:18-1,1,0,0
01:19-0,1,1,0
01:20-0,0,0,1
01:21-1,1,0,0
01:22-0,1,1,0
01:23-0,0,0,1
01:24-0,0,1,0
01:25-1,0,0,0
01:26-1,0,0,1
01:27-0,0,1,1
01:28-0,0,1,0
01:29-0,1,0,0
01:30-0,0,1,0
01:31-0,1,1,0
01:32-0,1,1,0
01:33-1,0,0,1
01:34-0,1,1,0
01:35-1,1,0,0
01:36-0,1,1,0
01:37-1,1,0,0
01:38-0,0,0,1
01:39-0,1,1,0
01:40-0,0,1,0
